You wake up and realize that you have become considerably dumber and that your brain function and motor skills are a bit off. You think that it may be because of the large amount of glitter that you have been smoking. Anyhow you notice that everything around you is white and that you can barely move around or walk straight. After much thought you realize that you must get out of here before you go insane or die.

 You can ask the narwal for hints and type hint in certain rooms for hints
DERP
Don't smoke glitter by Dakota Miller
Release 1 / Serial number 141028 / Inform 7 build 6L38 (I6/v6.33 lib 6/12N) SD

White Room
An all white room with various shapes scattered around it, which are also white. In the corner there is a white cube and in the center of the room there is a white sphere. Hanging from the celing is a white celing lamp white a white bulb inside of it. On the floor is a white rug with a white table on it.

>break wall2
you smash into the wall with your head and die

* * *

>w
You run into the wall and die

    *** You were killed by a Wall ***

Would you like to RESTART, RESTORE a saved game, QUIT or UNDO the last command?

* * *

>x cube
A plain white box

>open cube
You open the white cube revealing an assortment of packing supplies, including  a bottle of glue, a roll of bubble wrap, a roll of tape,a sheet of stamps, a used condom and a generous sprinkling of glitter inside of the cube.

>x bubble wrap
wrapping that's great for padding packages

>nn
That's not a verb I recognise.

>n
You run into the wall and die

    *** You were killed by a Wall ***

Would you like to RESTART, RESTORE a saved game, QUIT or UNDO the last command?

>walk
Please give one of the answers above.

Would you like to RESTART, RESTORE a saved game, QUIT or UNDO the last command?

>fuck u
Please give one of the answers above.

Would you like to RESTART, RESTORE a saved game, QUIT or UNDO the last command?

* * *

>i
You are carrying:
  magic potion

* * *

>open white cube
You open the white cube revealing an assortment of packing supplies, including  a bottle of glue, a roll of bubble wrap, a roll of tape, a sheet of stamps, a used condom and a generous sprinkling of glitter inside of the cube.

>take elixir
Taken.

>take gle
You can't see any such thing.

>take glue
Taken.

>take wrap
Taken.

>wear wrap
You put on Bubble wrap.

>s
Green Room
An all green room with various shapes scattered around it, which are also green. In the corner there is a green cube and in the center of the room there is a green sphere. Hanging from the celling is a green celling lamp whit a green bulb inside of it. On the floor is a green rug with a green table on it.

>take elixir
(white elixir)
You already have that.

>take green elixir
Taken.

>nn
That's not a verb I recognise.

>n
White Room
An all white room with various shapes scattered around it, which are also white. In the corner there is a white cube and in the center of the room there is a white sphere. Hanging from the celling is a white celling lamp white a white bulb inside of it. On the floor is a white rug with a white table on it.

>n
Orange Room
An all orange room with various shapes scattered around it, which are also orange. In the corner there is a orange cube and in the center of the room there is a orange sphere. Hanging from the celling is a orange celling lamp whit a orange bulb inside of it. On the floor is a orange rug with a orange table on it.

>take orange elixir
Taken.

>n
Black Room
An all black room with various shapes scattered around it, which are also black. In the corner there is a black cube and in the center of the room there is a black sphere.  In the opposite corner there is a black mannequin that seems a bit out of place.  Hanging from the celling is a black celling lamp whit a black bulb inside of it. On the floor is a black rug with a black table on it.

>take pin
Taken.

>s
Orange Room
An all orange room with various shapes scattered around it, which are also orange. In the corner there is a orange cube and in the center of the room there is a orange sphere. Hanging from the celling is a orange celling lamp whit a orange bulb inside of it. On the floor is a orange rug with a orange table on it.

I beg your pardon?

>s
White Room
An all white room with various shapes scattered around it, which are also white. In the corner there is a white cube and in the center of the room there is a white sphere. Hanging from the celling is a white celling lamp white a white bulb inside of it. On the floor is a white rug with a white table on it.

>w
Red Room
An all red room with various shapes scattered around it, which are also red. In the corner there is a red cube and in the center of the room there is a red sphere. Hanging from the celling is a red celling lamp whit a red bulb inside of it. On the floor is a red rug with a red table on it. to the west there is a door labeled door1.

>take red elixir
Taken.

>combine red elixir with green elixir
You mix  together red elixir and green elixir.

You now have a RedGreen elixir.

>combine orange elixir with white elixir
You mix  together orange elixir and white elixir.

You now have a OrangeWhite elixir.

>combine orangewhite elixir with redgreen elixir
You mix  together OrangeWhite elixir and RedGreen elixir.

You now have a magic potion.

>drink magic potion
you feel a bit smarter and stronger and also realize that you have a key hanging around your neck

>unlock door1 with key
You unlock door1.

>w
(first opening door1)

yellow Room
An all yellow room with various shapes scattered around it, which are also yellow. In the corner there is a yellow cube and in the center of the room there is a yellow sphere. Hanging from the celling is a yellow celling lamp whit a yellow bulb inside of it. On the floor is a yellow rug with a yellow table on it. to the west there is a door labeled door2

>put glue on hand
You put the glue on your hand

>put hand on door2
you put you hand on the door

>open door2
You stick your hand to the door and pull it open

>w
(first opening door2)

Blue Room
An all blue room with various shapes scattered around it, which are also blue. In the corner there is a blue cube and in the center of the room there is a blue sphere. Hanging from the celling is a blue celling lamp whit a blue bulb inside of it. On the floor is a blue rug with a blue table on it. to the west there is a door  door3

>pick lock
I didn't understand that sentence.

>pick lock with pin
you shuffle the pin around for a bit until you hear a click

>w
you step through the door and out onto a city street that seems vaguely familiar to you
street
An empty street with a row of parked cars along it. The sidewalks are lined with small shops and different types of trees.

>w
    *** The End ***

Would you like to RESTART, RESTORE a saved game, QUIT or UNDO the last command?

>x me
Please give one of the answers above.

Would you like to RESTART, RESTORE a saved game, QUIT or UNDO the last command?

>s
Please give one of the answers above.

Would you like to RESTART, RESTORE a saved game, QUIT or UNDO the last command?

* * *

>open white cube
You open the white cube revealing an assortment of packing supplies, including  a bottle of glue, a roll of bubble wrap, a roll of tape, a sheet of stamps, a used condom and a generous sprinkling of glitter inside of the cube.

>take gue
You can't see any such thing.

>take glue
Taken.

>take wrap take elixir
I only understood you as far as wanting to take Bubble wrap.

>take wrap
Taken.

>take elixir
Taken.

>s
You run into the wall and die

    *** You were killed by a Wall ***

Would you like to RESTART, RESTORE a saved game, QUIT or UNDO the last command?

* * *

>open white cube
You open the white cube revealing an assortment of packing supplies, including  a bottle of glue, a roll of bubble wrap, a roll of tape, a sheet of stamps, a used condom and a generous sprinkling of glitter inside of the cube.

>wear wrap
(first taking Bubble wrap)
You put on Bubble wrap.

>e
Purple Room
An all purple room with various shapes scattered around it, which are also purple. In the corner there is a purple cube and in the center of the room there is a purple sphere. Hanging from the celling is a purple celling lamp whit a purple bulb inside of it. On the floor is a purple rug with a purple table on it.

>break wall
You smash your head into the wall and die

>n
    *** You were killed by a wall ***

Would you like to RESTART, RESTORE a saved game, QUIT or UNDO the last command?

* * *

>break wall
You smash your head into the wall and die

>rules on
    *** You were killed by a wall ***

Would you like to RESTART, RESTORE a saved game, QUIT or UNDO the last command?

>undo
The use of "undo" is forbidden in this game.

Would you like to RESTART, RESTORE a saved game, QUIT or UNDO the last command?

* * *

>ask narwal
You can't see any such thing.

* * *

>use the screen hero chat
That's not a verb I recognise.

>x cube
A plain white box

>x sphere
A plain white sphere

>x lamp
A plain white celling lamp

>x table
A plain white table on a white rug, on the table is a white elixir

>take rug
That's hardly portable.

>take elixir
Taken.

>i
You are carrying:
  white elixir

>drink elixir
There's nothing suitable to drink here.

>take cube
That's hardly portable.

>use elixir on cube
That's not a verb I recognise.

>x rug
 A plain white rug with a table on it

>x table
A plain white table on a white rug

>put elixir on cube
Putting things on White cube would achieve nothing.

>put elixir on sphere
Putting things on White sphere would achieve nothing.

>move cube
It is fixed in place.

>n
You run into the wall and die

    *** You were killed by a Wall ***

Would you like to RESTART, RESTORE a saved game, QUIT or UNDO the last command?

>also theres a contost
Please give one of the answers above.

Would you like to RESTART, RESTORE a saved game, QUIT or UNDO the last command?

>undo
White Room
[Previous turn undone.]

>open cube
You open the white cube revealing an assortment of packing supplies, including  a bottle of glue, a roll of bubble wrap, a roll of tape,a sheet of stamps, a used condom and a generous sprinkling of glitter inside of the cube.

>take all
You are far too stupid do that

>-_-
That's not a verb I recognise.

>take supplies
You can't see any such thing.

>take glue
Taken.

>take bubble wrap
Taken.

>take tape
Taken.

>take stamps
Taken.

>take condom
WHY WOULD YOU WANT TO TAKE THAT?

>fgt
That's not a verb I recognise.

>take packing supplies
You can't see any such thing.

>w
You run into the wall and die

    *** You were killed by a Wall ***

Would you like to RESTART, RESTORE a saved game, QUIT or UNDO the last command?

>undo
White Room
[Previous turn undone.]

>s
You run into the wall and die

    *** You were killed by a Wall ***

Would you like to RESTART, RESTORE a saved game, QUIT or UNDO the last command?

>undo
White Room
[Previous turn undone.]

>ur close
That's not a verb I recognise.

>e
You run into the wall and die

    *** You were killed by a Wall ***

Would you like to RESTART, RESTORE a saved game, QUIT or UNDO the last command?

>undo
White Room
[Previous turn undone.]

>put bubble wrap on
You put on Bubble wrap.

>i
You are carrying:
  sheet of stamps
  roll of tape
  Bubble wrap (being worn)
  bottle of glue
  white elixir

>n
Orange Room
An all orange room with various shapes scatteorange around it, which are also orange. In the corner there is a orange cube and in the center of the room there is a orange sphere. Hanging from the celling is a orange celling lamp whit a orange bulb inside of it. On the floor is a orange rug with a orange table on it.

>s
White Room
An all white room with various shapes scattered around it, which are also white. In the corner there is a white cube and in the center of the room there is a white sphere. Hanging from the celling is a white celling lamp whit a white bulb inside of it. On the floor is a white rug with a white table on it.

>w
Red Room
An all red room with various shapes scattered around it, which are also red. In the corner there is a red cube and in the center of the room there is a red sphere. Hanging from the celling is a red celling lamp whit a red bulb inside of it. On the floor is a red rug with a red table on it. to the west there is a door labled door1.

>e
White Room
An all white room with various shapes scattered around it, which are also white. In the corner there is a white cube and in the center of the room there is a white sphere. Hanging from the celling is a white celling lamp whit a white bulb inside of it. On the floor is a white rug with a white table on it.

>aww shit
That's not a verb I recognise.

>n
Orange Room
An all orange room with various shapes scatteorange around it, which are also orange. In the corner there is a orange cube and in the center of the room there is a orange sphere. Hanging from the celling is a orange celling lamp whit a orange bulb inside of it. On the floor is a orange rug with a orange table on it.

>x cube
A plain orange box

>open box
You can't see any such thing.

>open cube
It isn't something you can open.

>x sphere
A plain orange sphere

>x table
A plain orange table on a orange rug , on the table is a orange elixir

>take elixir
(white elixir)
You already have that.

>take orange elixir
Taken.

>n
Black Room
An all black room with various shapes scatteblack around it, which are also black. In the corner there is a black cube and in the center of the room there is a black sphere. Hanging from the celling is a black celling lamp whit a black bulb inside of it. On the floor is a black rug with a black table on it.

>take elixir
(black elixir)
Taken.

>n
You can't go that way.

>s
Orange Room
An all orange room with various shapes scatteorange around it, which are also orange. In the corner there is a orange cube and in the center of the room there is a orange sphere. Hanging from the celling is a orange celling lamp whit a orange bulb inside of it. On the floor is a orange rug with a orange table on it.

>e
Pink Room
An all pink room with various shapes scattered around it, which are also pink. In the corner there is a pink cube and in the center of the room there is a pink sphere. Hanging from the celling is a pink celling lamp whit a pink bulb inside of it. On the floor is a pink rug with a pink table on it.

You can see a narwal here.

>take pink elixir
Taken.

>s
Purple Room
An all purple room with various shapes scattepurple around it, which are also purple. In the corner there is a purple cube and in the center of the room there is a purple sphere. Hanging from the celling is a purple celling lamp whit a purple bulb inside of it. On the floor is a purple rug with a purple table on it.

>take purple elixir
Taken.

>w
White Room
An all white room with various shapes scattered around it, which are also white. In the corner there is a white cube and in the center of the room there is a white sphere. Hanging from the celling is a white celling lamp whit a white bulb inside of it. On the floor is a white rug with a white table on it.

>s
Green Room
An all green room with various shapes scattegreen around it, which are also green. In the corner there is a green cube and in the center of the room there is a green sphere. Hanging from the celling is a green celling lamp whit a green bulb inside of it. On the floor is a green rug with a green table on it.

>take elixir
(green elixir)
Taken.

>n
White Room
An all white room with various shapes scattered around it, which are also white. In the corner there is a white cube and in the center of the room there is a white sphere. Hanging from the celling is a white celling lamp whit a white bulb inside of it. On the floor is a white rug with a white table on it.

>e
Purple Room
An all purple room with various shapes scattepurple around it, which are also purple. In the corner there is a purple cube and in the center of the room there is a purple sphere. Hanging from the celling is a purple celling lamp whit a purple bulb inside of it. On the floor is a purple rug with a purple table on it.

>take elixir
Which do you mean, green elixir, purple elixir, pink elixir, black elixir, orange elixir or white elixir?

>take purple elixir
You already have that.

>?
That's not a verb I recognise.

>i
You are carrying:
  green elixir
  purple elixir
  pink elixir
  black elixir
  orange elixir
  sheet of stamps
  roll of tape
  Bubble wrap (being worn)
  bottle of glue
  white elixir

>s
You can't go that way.

>w
White Room
An all white room with various shapes scattered around it, which are also white. In the corner there is a white cube and in the center of the room there is a white sphere. Hanging from the celling is a white celling lamp whit a white bulb inside of it. On the floor is a white rug with a white table on it.

>w
Red Room
An all red room with various shapes scattered around it, which are also red. In the corner there is a red cube and in the center of the room there is a red sphere. Hanging from the celling is a red celling lamp whit a red bulb inside of it. On the floor is a red rug with a red table on it. to the west there is a door labled door1.

>w
(first opening door1)
It seems to be locked.

>i
You are carrying:
  green elixir
  purple elixir
  pink elixir
  black elixir
  orange elixir
  sheet of stamps
  roll of tape
  Bubble wrap (being worn)
  bottle of glue
  white elixir

>x door1
A door labled door 1  with a piece of paper stuck to it

>take paper
Taken.

>x paper
a crumpled piece of paper

>x door
You can't see any such thing.

>read paper
the paper reads GROW your brain

>drink green elixir
There's nothing suitable to drink here.

>x doorl
You can't see any such thing.

>x door1
A door labled door 1

>combine the elixirs
You can't see any such thing.

>take red elixir
Taken.

>combine green elixir with red elixir
You mix  together green elixir and red elixir.

You now have a RedGreen elixir.

>combine orange elixir with white elixir
You mix  together orange elixir and white elixir.

You now have a OrangeWhite elixir.

* * *

>combine orangewhite elixir with redgreen elixir
You mix  together OrangeWhite elixir and RedGreen elixir.

You now have a magic potion.

>drink potion
you feel a bit smarter and stronger and also realize that you have a key hanging around your neck

>unlock door with key
You can't see any such thing.

>unlock door1 with key
You unlock door1.

>w
(first opening door1)

yellow Room
An all yellow room with various shapes scatteyellow around it, which are also yellow. In the corner there is a yellow cube and in the center of the room there is a yellow sphere. Hanging from the celling is a yellow celling lamp whit a yellow bulb inside of it. On the floor is a yellow rug with a yellow table on it. to the west there is a door labled door2

>x door2
A door labled door2 that is unlocked but has no door handle on it

>take yellow elixir
Which do you mean, Yellow sphere, Yellow light bulb, Yellow celling lamp, Yellow cube, yellow table or Yellow rug?

>x table
A plain yellow table on a yellow rug

>x cube
A plain yellow box

>x sphere
A plain yellow sphere

>open door
You can't see any such thing.

>open door2
You try to open the door, but there is no handle to open it with

>i
You are carrying:
  key
  paper
  purple elixir
  pink elixir
  black elixir
  sheet of stamps
  roll of tape
  Bubble wrap (being worn)
  bottle of glue

>glue key to door2
That's not a verb I recognise.

>combine glue with key
You can't combine bottle of glue and key into anything useful.
Try another combination of things.

>combine glue with stamps
You can't combine bottle of glue and sheet of stamps into anything useful.
Try another combination of things.

>put glue on door
You can't see any such thing.

>put glue on door2
Putting things on door2 would achieve nothing.

>put glue on table
Putting things on yellow table would achieve nothing.

>put glue on cube
Putting things on Yellow cube would achieve nothing.

>?
That's not a verb I recognise.

>put glue on hand
You put the glue on your hand

>put hand on door
You can't see any such thing.

>put hand on door2
You can't see any such thing.

>open door2
You stick your hand to the door and pull it open

>w
(first opening door2)

Blue Room
An all blue room with various shapes scatteblue around it, which are also blue. In the corner there is a blue cube and in the center of the room there is a blue sphere. Hanging from the celling is a blue celling lamp whit a blue bulb inside of it. On the floor is a blue rug with a blue table on it. to the west there is a door labled door3

>FUCK
That's not a verb I recognise.

>take blue elixir
Which do you mean, Blue sphere, Blue light bulb, Blue celling lamp, Blue cube, blue table or Blue rug?

>take all
You are far too stupid do that
There are none at all available!

>x door3
Door 3

* * *

>x door
please specify which door you want to examine

>x door2
You can't see any such thing.

>x door1
You can't see any such thing.

>x door3
You can't see any such thing.

>open cube
You open the white cube revealing an assortment of packing supplies, including  a bottle of glue, a roll of bubble wrap, a roll of tape,a sheet of stamps, a used condom and a generous sprinkling of glitter inside of the cube.

>wear bubble wrap
(first taking Bubble wrap)
You put on Bubble wrap.

>e
Purple Room
An all purple room with various shapes scattered around it, which are also purple. In the corner there is a purple cube and in the center of the room there is a purple sphere. Hanging from the celling is a purple celling lamp whit a purple bulb inside of it. On the floor is a purple rug with a purple table on it.

>w
White Room
An all white room with various shapes scattered around it, which are also white. In the corner there is a white cube and in the center of the room there is a white sphere. Hanging from the celling is a white celling lamp white a white bulb inside of it. On the floor is a white rug with a white table on it.

>w
Red Room
An all red room with various shapes scattered around it, which are also red. In the corner there is a red cube and in the center of the room there is a red sphere. Hanging from the celling is a red celling lamp whit a red bulb inside of it. On the floor is a red rug with a red table on it. to the west there is a door labled door1.

>x door1
A door labled Door1 with a piece of paper stuck to it

* * *

>DERP2
That's not a verb I recognise.

I beg your pardon?

>talk
That's not a verb I recognise.

>x me
 you are naked

>break wall
you smash into the wall with your head and die

>n
You run into the wall and die

    *** You were killed by a Wall ***

Would you like to RESTART, RESTORE a saved game, QUIT or UNDO the last command?

* * *

>hint
there is a container in this room

>open white cube
You open the white cube revealing an assortment of packing supplies, including  a bottle of glue, a roll of bubble wrap, a roll of tape, a sheet of stamps, a used condom and a generous sprinkling of glitter inside of the cube.

* * *

>open white cube
You open White cube, revealing nothing.

>wear buble wrap
You can't see any such thing.

>wear bubble wrap
(first taking Bubble wrap)
You put on Bubble wrap.

>w
Red Room
An all red room with various shapes scattered around it, which are also red. In the corner there is a red cube and in the center of the room there is a red sphere. Hanging from the celling is a red celling lamp whit a red bulb inside of it. On the floor is a red rug with a red table on it. to the west there is a door labled door1.

* * *

>e
White Room
An all white room with various shapes scattered around it, which are also white. In the corner there is a white cube and in the center of the room there is a white sphere. Hanging from the celling is a white celling lamp whit a white bulb inside of it. On the floor is a white rug with a white table on it.

>take magic potion
Taken.

>e
Purple Room
An all purple room with various shapes scattepurple around it, which are also purple. In the corner there is a purple cube and in the center of the room there is a purple sphere. Hanging from the celling is a purple celling lamp whit a purple bulb inside of it. On the floor is a purple rug with a purple table on it.

>w
White Room
An all white room with various shapes scattered around it, which are also white. In the corner there is a white cube and in the center of the room there is a white sphere. Hanging from the celling is a white celling lamp whit a white bulb inside of it. On the floor is a white rug with a white table on it.

* * *

>w
Red Room
An all red room with various shapes scattered around it, which are also red. In the corner there is a red cube and in the center of the room there is a red sphere. Hanging from the celling is a red celling lamp whit a red bulb inside of it. On the floor is a red rug with a red table on it. to the west there is a door labled door1.

>deink magic potion
That's not a verb I recognise.

>drink magic potion
you feel a bit smarter and stronger and also realize that you have a key hanging around your neck

>x key
You can't see any such thing.

>i
You are carrying:
  magic potion
  Bubble wrap (being worn)

* * *

>take magic potion
You already have that.

>drink magic potion
you feel a bit smarter and stronger

>w
You run into the wall and die

    *** You were killed by a Wall ***

Would you like to RESTART, RESTORE a saved game, QUIT or UNDO the last command?

* * *

>x box
You can't see any such thing.

>x cubr
You can't see any such thing.

>x cube
A plain white box

>open cube
Be more specific

>open white cube
You open the white cube revealing an assortment of packing supplies, including  a bottle of glue, a roll of bubble wrap, a roll of tape, a sheet of stamps, a moldy bread and a generous sprinkling of glitter inside of the cube.

>hint
What could make you not hit the wall so hard?

>take bubble wrap
Taken.

>take glue
Taken.

>take tape
Taken.

>l
White Room
An all white room with various shapes scattered around it, which are also white. In the corner there is a white cube and in the center of the room there is a white sphere. Hanging from the celing is a white celing lamp white a white bulb inside of it. On the floor is a white rug with a white table on it.

>put bubble wrap on wall
You can't see any such thing.

>wear bubble wrap
You put on Bubble wrap.

>n
Orange Room
An all orange room with various shapes scattered around it, which are also orange. In the corner there is a orange cube and in the center of the room there is a orange sphere. Hanging from the celing is a orange celing lamp whit a orange bulb inside of it. On the floor is a orange rug with a orange table on it.

>open cube
It isn't something you can open.

* * *

>break wal
You can't see any such thing.

>break wall
You break through the wall and and step out onto a city street and notice that this place seems vaguely familiarYou can't see any such thing.

* * *

>open box
You can't see any such thing.

* * *

>drink orange elixir
You can't see any such thing.

* * *

>break wall
You can't see any such thing.

>x cube
    *** You break through the wall and and step out onto a city street and notice that this place seems vaguely familiar. You found the easy way out ***

Would you like to RESTART, RESTORE a saved game, QUIT or UNDO the last command?

* * *

>x bulb
A plain white light bulb

>x cube
A plain white box

>break wall
You can't see any such thing.

>s
You run into the wall and die

    *** You were killed by a Wall ***

Would you like to RESTART, RESTORE a saved game, QUIT or UNDO the last command?

>restart
You wake up and realize that you have become considerably dumber and that your brain function and motor skills are a bit off. You think that it may be because of the large amount of glitter that you have been smoking. Anyhow you notice that everything around you is white and that you can barely move around or walk straight. After much thought you realize that you must get out of here before you go insane or die.

 You can ask the narwal for hints and type hint in certain rooms for hints
DERP
Don't smoke glitter by Dakota Miller
Release 1 / Serial number 141028 / Inform 7 build 6L38 (I6/v6.33 lib 6/12N) SD

White Room
An all white room with various shapes scattered around it, which are also white. In the corner there is a white cube and in the center of the room there is a white sphere. Hanging from the celing is a white celing lamp white a white bulb inside of it. On the floor is a white rug with a white table on it.

>rules on
Rules tracing now switched on. Type "rules off" to switch it off again, or "rules all" to include even rules which do not apply.

>break wall
[Rule "After reading a command" applies.]
[Rule "After reading a command" applies.]
[Rule "After reading a command" applies.]
[Rule "After reading a command" applies.]
[Rule "After reading a command" applies.]
[Rule "After reading a command" applies.]
[Rule "After reading a command" applies.]
[Rule "After reading a command" applies.]
[Rule "After reading a command" applies.]
[Rule "After reading a command" applies.]
[Rule "After reading a command" applies.]
[Rule "After reading a command" applies.]
[Rule "After reading a command" applies.]
[Rule "After reading a command" applies.]
[Rule "After reading a command" applies.]
[Rule "After reading a command" applies.]
[Rule "After reading a command" applies.]
[Rule "After reading a command" applies.]
[Rule "After reading a command" applies.]
[Rule "After reading a command" applies.]
[Rule "After reading a command" applies.]
[Rule "After reading a command" applies.]
[Rule "After reading a command" applies.]
[Rule "After reading a command" applies.]
[Rule "After reading a command" applies.]
[Rule "After reading a command" applies.]
[Rule "After reading a command" applies.]
[Rule "After reading a command" applies.]
[Rule "After reading a command" applies.]
[Rule "After reading a command" applies.]
[Rule "After reading a command" applies.]
[Rule "After reading a command" applies.]
[Rule "After reading a command" applies.]
[Rule "After reading a command" applies.]
[Rule "After reading a command" applies.]
[Rule "After reading a command" applies.]
[Rule "After reading a command" applies.]
[Rule "After reading a command" applies.]
[Rule "After reading a command" applies.]
[Rule "After reading a command" applies.]
[Rule "After reading a command" applies.]
[Rule "After reading a command" applies.]
[Rule "After reading a command" applies.]
[Rule "After reading a command" applies.]
[Rule "After reading a command" applies.]
[Rule "After reading a command" applies.]
[Rule "After reading a command" applies.]
[Rule "After reading a command" applies.]
[Rule "After reading a command" applies.]
[Rule "After reading a command" applies.]
[Rule "After reading a command" applies.]
[Rule "After reading a command" applies.]
[Rule "After reading a command" applies.]
[Rule "After reading a command" applies.]
[Rule "After reading a command" applies.]
You can't see any such thing.