You wake up and realize that you have become considerably dumber and that you have the brain function and motor skills of a three year old. You think that it may be the large ammount of meth that you have been smoking. Anyhow you notice that everything around you is white and that you can barely move around or walk straight. After much thought you realize that you must get out of here before you go insane or die.

DERP
An Interactive Fiction by Dakota Miller
Release 1 / Serial number 141023 / Inform 7 build 6L38 (I6/v6.33 lib 6/12N) SD

White Room
An all white room with various shapes scattered around it, which are also white. In the corner there is a white cube and in the center of the room there is a white sphere. Hanging from the celling is a white celling lamp whit a white bulb inside of it. On the floor is a white rug with a white table on it.

>take elixir
Taken.

>open cube
You open White cube, revealing bottle of glue.

>wear bubble wrap
(first taking Bubble wrap)
You put on Bubble wrap.

* * *

>w
Red Room
An all red room with various shapes scattered around it, which are also red. In the corner there is a red cube and in the center of the room there is a red sphere. Hanging from the celling is a red celling lamp whit a red bulb inside of it. On the floor is a red rug with a red table on it. to the west there is a door labled door1.

>take elixir
(white elixir)
You already have that.

>take red elixir
Taken.

>e
White Room
An all white room with various shapes scattered around it, which are also white. In the corner there is a white cube and in the center of the room there is a white sphere. Hanging from the celling is a white celling lamp whit a white bulb inside of it. On the floor is a white rug with a white table on it.

>s
Green Room
An all green room with various shapes scattegreen around it, which are also green. In the corner there is a green cube and in the center of the room there is a green sphere. Hanging from the celling is a green celling lamp whit a green bulb inside of it. On the floor is a green rug with a green table on it.

>take green elixir
Taken.

>n
White Room
An all white room with various shapes scattered around it, which are also white. In the corner there is a white cube and in the center of the room there is a white sphere. Hanging from the celling is a white celling lamp whit a white bulb inside of it. On the floor is a white rug with a white table on it.

>n
Orange Room
An all orange room with various shapes scatteorange around it, which are also orange. In the corner there is a orange cube and in the center of the room there is a orange sphere. Hanging from the celling is a orange celling lamp whit a orange bulb inside of it. On the floor is a orange rug with a orange table on it.

>take orange elixir
Taken.

>combine orange elixir with white elixir
You fuse together orange elixir and white elixir.

You now have a OrangeWhite elixir.

>combine green elixer with red elixir
I didn't understand that sentence.

>combine green elixir with red elixir
You fuse together green elixir and red elixir.

You now have a RedGreen elixir.

* * *

>w
You run into the wall and die

    *** You were killed by a Wall ***

Would you like to RESTART, RESTORE a saved game, QUIT or UNDO the last command?

* * *

>rules on
Rules tracing now switched on. Type "rules off" to switch it off again, or "rules all" to include even rules which do not apply.

>e
[Rule "After reading a command" applies.]
You run into the wall and die
[Rule "when play ends stage rule" applies.]
[Rule "print player's obituary rule" applies.]

    *** You were killed by a door frame ***

[Rule "print the final question rule" applies.]
Would you like to RESTART, RESTORE a saved game, QUIT or UNDO the last command?
[Rule "print the final prompt rule" applies.]

>rules off
[Rule "standard respond to final question rule" applies.]
Please give one of the answers above.

[Rule "print the final question rule" applies.]
Would you like to RESTART, RESTORE a saved game, QUIT or UNDO the last command?
[Rule "print the final prompt rule" applies.]

* * *

>i
You are carrying:
  magic potion

* * *

>ope  white cube
That's not a verb I recognise.

>open white cube
You open White cube, revealing nothing.

>put on bubble wrap
(first taking Bubble wrap)
You put on Bubble wrap.

>n
Orange Room

>s
White Room

>e
Purple Room

>w
White Room

>n
Orange Room

>e
Pink Room
You can see a narwal here.

>talk to narwal
That's not a verb I recognise.

>ask narwal
(for Bubble wrap)
(the narwal first taking Bubble wrap)
The narwal has better things to do.

>rules on
Rules tracing now switched on. Type "rules off" to switch it off again, or "rules all" to include even rules which do not apply.

>ask narwal
[Rule "After reading a command" applies.]
(for Bubble wrap)
[Rule "declare everything initially unmentioned rule" applies.]
[Rule "announce items from multiple object lists rule" applies.]
[Rule "set pronouns from items from multiple object lists rule" applies.]
[Rule "before stage rule" applies.]
[Rule "instead stage rule" applies.]
[Rule "investigate player's awareness before action rule" applies.]
[Rule "player aware of his own actions rule" applies.]
[Rule "check stage rule" applies.]
[Rule "asking yourself for something rule" applies.]
[Rule "translate asking for to giving rule" applies.]
[Rule "announce items from multiple object lists rule" applies.]
[Rule "set pronouns from items from multiple object lists rule" applies.]
[Rule "before stage rule" applies.]
(the narwal first taking Bubble wrap)
[Rule "announce items from multiple object lists rule" applies.]
[Rule "set pronouns from items from multiple object lists rule" applies.]
[Rule "before stage rule" applies.]
[Rule "instead stage rule" applies.]
The narwal has better things to do.

[Rule "A first turn sequence rule" applies.]
[Rule "every turn stage rule" applies.]
[Rule "A last turn sequence rule" applies.]
[Rule "notify score changes rule" applies.]

* * *

>open white cube
You open the white cube revealing an assortment of packing supplies, including  a bottle of glue, a roll of bubble wrap, a roll of tape,a sheet of stamps, a used condom and a generous sprinkling of glitter inside of the cube.

>take used condom
WHY WOULD YOU WANT TO TAKE THAT?

>take wrap
Taken.

>take glue
Taken.

I beg your pardon?

>wear wrap
You put on Bubble wrap.

>w
Red Room
An all red room with various shapes scattered around it, which are also red. In the corner there is a red cube and in the center of the room there is a red sphere. Hanging from the celling is a red celling lamp whit a red bulb inside of it. On the floor is a red rug with a red table on it. to the west there is a door labled door1.

>w
(first opening door1)

yellow Room
An all yellow room with various shapes scatteyellow around it, which are also yellow. In the corner there is a yellow cube and in the center of the room there is a yellow sphere. Hanging from the celling is a yellow celling lamp whit a yellow bulb inside of it. On the floor is a yellow rug with a yellow table on it. to the west there is a door labled door2

>open door2
You try to open the door, but there is no handle to open it with

>i
You are carrying:
  bottle of glue
  Bubble wrap (being worn)

>put glue on hand
You put the glue on your hand

* * *

>ask narwal
You can't see any such thing.

>n
You run into the wall and die

    *** You were killed by a Wall ***

Would you like to RESTART, RESTORE a saved game, QUIT or UNDO the last command?

>e
Please give one of the answers above.

Would you like to RESTART, RESTORE a saved game, QUIT or UNDO the last command?

* * *

>drink magic potion
You can't see any such thing.

>open wite
You can't see any such thing.

* * *

>drink magic potion
You can't see any such thing.

>take magic potion
Taken.

>drink mgic potion
You can't see any such thing.

>drink magic potion
the paper reads GROW

* * *

>take magic potion
You already have that.

>open white cube
You open White cube, revealing nothing.

* * *

>put on bubble wrap
(first taking Bubble wrap)
You put on Bubble wrap.

>w
Red Room
An all red room with various shapes scattered around it, which are also red. In the corner there is a red cube and in the center of the room there is a red sphere. Hanging from the celling is a red celling lamp whit a red bulb inside of it. On the floor is a red rug with a red table on it. to the west there is a door labled door1.

>drink magic potion
you feel a bit smarter

>e
White Room
An all white room with various shapes scattered around it, which are also white. In the corner there is a white cube and in the center of the room there is a white sphere. Hanging from the celling is a white celling lamp whit a white bulb inside of it. On the floor is a white rug with a white table on it.

>w
Red Room
An all red room with various shapes scattered around it, which are also red. In the corner there is a red cube and in the center of the room there is a red sphere. Hanging from the celling is a red celling lamp whit a red bulb inside of it. On the floor is a red rug with a red table on it. to the west there is a door labled door1.

* * *

>open white cube
You open White cube, revealing nothing.

* * *

>OPEN WHITE CUBE
You open the white cube revealing an assortment of packing supplies, including  a bottle of glue, a roll of bubble wrap, a roll of tape,a sheet of stamps, a used condom and a generous sprinkling of glitter inside of the cube.

>wear bubble wrap
(first taking Bubble wrap)
You put on Bubble wrap.

* * *

>w
Red Room
An all red room with various shapes scattered around it, which are also red. In the corner there is a red cube and in the center of the room there is a red sphere. Hanging from the celling is a red celling lamp whit a red bulb inside of it. On the floor is a red rug with a red table on it. to the west there is a door labled door1.

>open door1
It seems to be locked.

>e
White Room
An all white room with various shapes scattered around it, which are also white. In the corner there is a white cube and in the center of the room there is a white sphere. Hanging from the celling is a white celling lamp whit a white bulb inside of it. On the floor is a white rug with a white table on it.

>take glue
Taken.

>take elixir
Taken.

>w
Red Room
An all red room with various shapes scattered around it, which are also red. In the corner there is a red cube and in the center of the room there is a red sphere. Hanging from the celling is a red celling lamp whit a red bulb inside of it. On the floor is a red rug with a red table on it. to the west there is a door labled door1.

>take red elixir
Taken.

* * *

>e
White Room
An all white room with various shapes scattered around it, which are also white. In the corner there is a white cube and in the center of the room there is a white sphere. Hanging from the celling is a white celling lamp whit a white bulb inside of it. On the floor is a white rug with a white table on it.

>e
Purple Room
An all purple room with various shapes scattepurple around it, which are also purple. In the corner there is a purple cube and in the center of the room there is a purple sphere. Hanging from the celling is a purple celling lamp whit a purple bulb inside of it. On the floor is a purple rug with a purple table on it.

* * *

>take green elixir
Taken.

>i
You are carrying:
  green elixir
  red elixir
  white elixir
  bottle of glue
  Bubble wrap (being worn)

>n
White Room
An all white room with various shapes scattered around it, which are also white. In the corner there is a white cube and in the center of the room there is a white sphere. Hanging from the celling is a white celling lamp whit a white bulb inside of it. On the floor is a white rug with a white table on it.

* * *

>n
Orange Room
An all orange room with various shapes scatteorange around it, which are also orange. In the corner there is a orange cube and in the center of the room there is a orange sphere. Hanging from the celling is a orange celling lamp whit a orange bulb inside of it. On the floor is a orange rug with a orange table on it.

>take orand elixir
You can't see any such thing.

>take orange elixir
Taken.

>i
You are carrying:
  orange elixir
  green elixir
  red elixir
  white elixir
  bottle of glue
  Bubble wrap (being worn)

* * *

>wear buble wrap
You can't see any such thing.

* * *

>n
You run into the wall and die

    *** You were killed by a Wall ***

Would you like to RESTART, RESTORE a saved game, QUIT or UNDO the last command?

>e
Pink Room
You can see a narwal here.

>x narwal
 Nothing other than a pink narwal

>kill narwal
Violence isn't the answer to this one.

>n
You can't go that way.

>s
Purple Room

>e
You can't go that way.

>w
White Room

>p
That's not a verb I recognise.

>e
Purple Room

>n
Pink Room
You can see a narwal here.

>i
You are carrying nothing.

>s
Purple Room

>n
Pink Room
You can see a narwal here.

I beg your pardon?

>s
Purple Room

* * *

>n
You run into the wall and die

    *** You were killed by a Wall ***

Would you like to RESTART, RESTORE a saved game, QUIT or UNDO the last command?

>north
Please give one of the answers above.

Would you like to RESTART, RESTORE a saved game, QUIT or UNDO the last command?

>undo
White Room
[Previous turn undone.]

>north
You run into the wall and die

    *** You were killed by a door frame ***

Would you like to RESTART, RESTORE a saved game, QUIT or UNDO the last command?

* * *

>n
You run into the wall and die

    *** You were killed by a Wall ***

Would you like to RESTART, RESTORE a saved game, QUIT or UNDO the last command?

>restart
DERP
DERP
An Interactive Fiction by Dakota Miller
Release 1 / Serial number 141016 / Inform 7 build 6L38 (I6/v6.33 lib 6/12N) SD

White Room
An all white room with various shapes scattered around it, which are also white. In the cornert there is a white cube and in the center of the room there is a white sphere. hanging from the celing is a white celing lamp whit a white bulb inside of it. On the floor is w white rug with a white table on it.

* * *

>wear bubble wrap
(first taking Bubble wrap)
You put on Bubble wrap.

>n
Orange Room

* * *

>w
White Room

>take off bubble wrap
You take off Bubble wrap.

>n
You run into the wall and die

>s
You run into the wall and die

>e
You run into the wall and die

>w
You run into the wall and die